1111111111111111
100C000000100001
10C0000000000001
100001000000C001
10E0010CP0000001
1111111111111111











