11111111111111111111111
100C0000001000000000001
10C0X000000000000000001
100001000000C0000000001
10E0010CP00000000000001
11111111111111111111111
