11111111111111111111111
1000C000001000000000001
1000X000000000000000001
10C0010000000000000C001
10E00100P00000000000001
11111111111111111111111
